type octile
height 12
width 20
map
TTTTTTTTTTTTTTTTTTTT
T..................T
T....T.....T.......T
T....T.....TT......T
T..................T
T.......T..........T
T..................T
T......TTT.........T
T..................T
T..................T
T..................T
TTTTTTTTTTTTTTTTTTTT